##################################################################
#................................................................#
#................................................................#
#.............,,,,,,,,,,,,,,,,,,,,,,,,,,,,,,,,,,,,,,,,,,,,,......#
#............................>.......,,,,,,,,,,,,,,,,,,,,,,,,....#
#................................................................#
#.......................................#.#~~~~~~~~..............#
#.......................................#.#~~~~~~~...............#
#.......................................#.#~~~~~~................#
#.......................................#.#~~~~~.................#
#..................................######.######.................#
#..................................#...........#.................#
#..................................#...........#.................#
#........................###########...........#.................#
#........................#.....................#LLLLLL...........#
#........................#.#########...........#LLLLLL...........#
#........................#.#.......#...........#.LLLLL...........#
##########...............#.#.......#...........#.................#
#........#################.#.......#############.................#
#..........................#.....................................#
#........###################.....................................#
##################################################################